################
#1  $$$$$$$$$$$#
#   #$$$$$$$$$$#
#   $$$$$$ #$$$#
#$$$$$#$$$$$ $$#
#$$$$$$$$$$$$$$#
#  #$$$$$  # $$#
#$$$$$$$$$$$$$$#
#$$$$$$#  $$$$ #
#$$$$$$$$$$$$$$#
#  $$$$   #    #
#$$$$$$$$$$$$$$#
#$$$#$$ $$$$$  #
#$$$$$$$$##$$  #
#$$$$$$$$$$$  2#
################